................
......#.........
.........#......
....####........
....#..#........
....#..#......#
....####........
.....#..........
........@.......
...#.......#....
.......#........

